******X**X
**X****XX*
**X*XXX***
X***X*X*X*
***XXX****
**XX****X*
*X*XXX*X*X
********XX
X*X*X*****
XX***X****
