********X*****X****X
**XX***XXX***X**XX**
X*X*****X******X*XX*
***X**XX*X*XXX****X*
X***X***X*X***XX*X**
*******X**********X*
********XXX**X***XXX
**X*X*X*X*X****X*X*X
*****XXX*X*X***X****
*X*X**X**X*X*X***XXX
**X********XXXX***X*
****XX****X*****X*X*
X*X*XX**X*X*XX******
X*****X*X*X*XXX*****
*******X****X*X*XX**
****XX*XX*X****X****
**XX*X******X****X**
****XX******X**XX*X*
***X**XX**X*X****XX*
X**X*XX******X***X**
